Conda	Anna	annaconda@sio.jjr.fr	x8zzDgs§c
Gramme	Anna	annagramme@sio.jjr.fr	x8zzDgs§c
Show	Arty	artyshow@sio.jjr.fr	x8zzDgs§c
Bor�al	Aurore	aurorebor�al@sio.jjr.fr	x8zzDgs§c
Sonjoli	Axelle	axellesonjoli@sio.jjr.fr	x8zzDgs§c
Ohazar	Balthazar	balthazarohazar@sio.jjr.fr	x8zzDgs§c
de Koch	Basile	basilede koch@sio.jjr.fr	x8zzDgs§c
Pacher	Bonaparte	bonapartepacher@sio.jjr.fr	x8zzDgs§c
Glace	Brice	briceglace@sio.jjr.fr	x8zzDgs§c
Nulpart	Carmen	carmennulpart@sio.jjr.fr	x8zzDgs§c
Trophob	Claus	claustrophob@sio.jjr.fr	x8zzDgs§c
Molette	Cl�a	cl�amolette@sio.jjr.fr	x8zzDgs§c
Sil	Cody	codysil@sio.jjr.fr	x8zzDgs§c
Rondi	Deborah	deborahrondi@sio.jjr.fr	x8zzDgs§c
�pi	Fany	fany�pi@sio.jjr.fr	x8zzDgs§c
Passy	Flore	florepassy@sio.jjr.fr	x8zzDgs§c
Citon	Garry	garryciton@sio.jjr.fr	x8zzDgs§c
Mer	G�rard	g�rardmer@sio.jjr.fr	x8zzDgs§c
Monlatin	Gilbert	gilbertmonlatin@sio.jjr.fr	x8zzDgs§c
de Michelin	Guy	guyde michelin@sio.jjr.fr	x8zzDgs§c
Ness	Guy	guyness@sio.jjr.fr	x8zzDgs§c
Dehun	H�l�ne	h�l�nedehun@sio.jjr.fr	x8zzDgs§c
Sarav	Igor	igorsarav@sio.jjr.fr	x8zzDgs§c
Lepoisson	Ivanho�	ivanho�lepoisson@sio.jjr.fr	x8zzDgs§c
Tretou	Jean-R�gis	jean-r�gistretou@sio.jjr.fr	x8zzDgs§c
Calva	Justin	justincalva@sio.jjr.fr	x8zzDgs§c
Page	Marc	marcpage@sio.jjr.fr	x8zzDgs§c
Tim	Marie	marietim@sio.jjr.fr	x8zzDgs§c
Cambronne	Maude	maudecambronne@sio.jjr.fr	x8zzDgs§c
Enroute	M�lodie	m�lodieenroute@sio.jjr.fr	x8zzDgs§c
Archi	Sue	suearchi@sio.jjr.fr	x8zzDgs§c
Incoufin	Pat	patincoufin@sio.jjr.fr	x8zzDgs§c
