Conda	Anna	annaconda@sio.jjr.fr	aconda
Gramme	Anna	annagramme@sio.jjr.fr	agramme
Show	Arty	artyshow@sio.jjr.fr	ashow
Bor�al	Aurore	aurorebor�al@sio.jjr.fr	abor�al
Sonjoli	Axelle	axellesonjoli@sio.jjr.fr	asonjoli
Ohazar	Balthazar	balthazarohazar@sio.jjr.fr	bohazar
de Koch	Basile	basilede koch@sio.jjr.fr	bde koch
Pacher	Bonaparte	bonapartepacher@sio.jjr.fr	bpacher
Glace	Brice	briceglace@sio.jjr.fr	bglace
Nulpart	Carmen	carmennulpart@sio.jjr.fr	cnulpart
Trophob	Claus	claustrophob@sio.jjr.fr	ctrophob
Molette	Cl�a	cl�amolette@sio.jjr.fr	cmolette
Sil	Cody	codysil@sio.jjr.fr	csil
Rondi	Deborah	deborahrondi@sio.jjr.fr	drondi
�pi	Fany	fany�pi@sio.jjr.fr	f�pi
Passy	Flore	florepassy@sio.jjr.fr	fpassy
Citon	Garry	garryciton@sio.jjr.fr	gciton
Mer	G�rard	g�rardmer@sio.jjr.fr	gmer
Monlatin	Gilbert	gilbertmonlatin@sio.jjr.fr	gmonlatin
de Michelin	Guy	guyde michelin@sio.jjr.fr	gde michelin
Ness	Guy	guyness@sio.jjr.fr	gness
Dehun	H�l�ne	h�l�nedehun@sio.jjr.fr	hdehun
Sarav	Igor	igorsarav@sio.jjr.fr	isarav
Lepoisson	Ivanho�	ivanho�lepoisson@sio.jjr.fr	ilepoisson
Tretou	Jean-R�gis	jean-r�gistretou@sio.jjr.fr	jtretou
Calva	Justin	justincalva@sio.jjr.fr	jcalva
Page	Marc	marcpage@sio.jjr.fr	mpage
Tim	Marie	marietim@sio.jjr.fr	mtim
Cambronne	Maude	maudecambronne@sio.jjr.fr	mcambronne
Enroute	M�lodie	m�lodieenroute@sio.jjr.fr	menroute
Archi	Sue	suearchi@sio.jjr.fr	sarchi
Incoufin	Pat	patincoufin@sio.jjr.fr	pincoufin
