Conda	Anna	annaconda@sio.jjr.fr	mb3pRtie:
Gramme	Anna	annagramme@sio.jjr.fr	mb3pRtie:
Show	Arty	artyshow@sio.jjr.fr	mb3pRtie:
Bor�al	Aurore	aurorebor�al@sio.jjr.fr	mb3pRtie:
Sonjoli	Axelle	axellesonjoli@sio.jjr.fr	mb3pRtie:
Ohazar	Balthazar	balthazarohazar@sio.jjr.fr	mb3pRtie:
de Koch	Basile	basilede koch@sio.jjr.fr	mb3pRtie:
Pacher	Bonaparte	bonapartepacher@sio.jjr.fr	mb3pRtie:
Glace	Brice	briceglace@sio.jjr.fr	mb3pRtie:
Nulpart	Carmen	carmennulpart@sio.jjr.fr	mb3pRtie:
Trophob	Claus	claustrophob@sio.jjr.fr	mb3pRtie:
Molette	Cl�a	cl�amolette@sio.jjr.fr	mb3pRtie:
Sil	Cody	codysil@sio.jjr.fr	mb3pRtie:
Rondi	Deborah	deborahrondi@sio.jjr.fr	mb3pRtie:
�pi	Fany	fany�pi@sio.jjr.fr	mb3pRtie:
Passy	Flore	florepassy@sio.jjr.fr	mb3pRtie:
Citon	Garry	garryciton@sio.jjr.fr	mb3pRtie:
Mer	G�rard	g�rardmer@sio.jjr.fr	mb3pRtie:
Monlatin	Gilbert	gilbertmonlatin@sio.jjr.fr	mb3pRtie:
de Michelin	Guy	guyde michelin@sio.jjr.fr	mb3pRtie:
Ness	Guy	guyness@sio.jjr.fr	mb3pRtie:
Dehun	H�l�ne	h�l�nedehun@sio.jjr.fr	mb3pRtie:
Sarav	Igor	igorsarav@sio.jjr.fr	mb3pRtie:
Lepoisson	Ivanho�	ivanho�lepoisson@sio.jjr.fr	mb3pRtie:
Tretou	Jean-R�gis	jean-r�gistretou@sio.jjr.fr	mb3pRtie:
Calva	Justin	justincalva@sio.jjr.fr	mb3pRtie:
Page	Marc	marcpage@sio.jjr.fr	mb3pRtie:
Tim	Marie	marietim@sio.jjr.fr	mb3pRtie:
Cambronne	Maude	maudecambronne@sio.jjr.fr	mb3pRtie:
Enroute	M�lodie	m�lodieenroute@sio.jjr.fr	mb3pRtie:
Archi	Sue	suearchi@sio.jjr.fr	mb3pRtie:
Incoufin	Pat	patincoufin@sio.jjr.fr	mb3pRtie:
