Conda	Anna	annaconda@sio.jjr.fr	qh!Wnqgx3
Gramme	Anna	annagramme@sio.jjr.fr	qh!Wnqgx3
Show	Arty	artyshow@sio.jjr.fr	qh!Wnqgx3
Bor�al	Aurore	aurorebor�al@sio.jjr.fr	qh!Wnqgx3
Sonjoli	Axelle	axellesonjoli@sio.jjr.fr	qh!Wnqgx3
Ohazar	Balthazar	balthazarohazar@sio.jjr.fr	qh!Wnqgx3
de Koch	Basile	basilede koch@sio.jjr.fr	qh!Wnqgx3
Pacher	Bonaparte	bonapartepacher@sio.jjr.fr	qh!Wnqgx3
Glace	Brice	briceglace@sio.jjr.fr	qh!Wnqgx3
Nulpart	Carmen	carmennulpart@sio.jjr.fr	qh!Wnqgx3
Trophob	Claus	claustrophob@sio.jjr.fr	qh!Wnqgx3
Molette	Cl�a	cl�amolette@sio.jjr.fr	qh!Wnqgx3
Sil	Cody	codysil@sio.jjr.fr	qh!Wnqgx3
Rondi	Deborah	deborahrondi@sio.jjr.fr	qh!Wnqgx3
�pi	Fany	fany�pi@sio.jjr.fr	qh!Wnqgx3
Passy	Flore	florepassy@sio.jjr.fr	qh!Wnqgx3
Citon	Garry	garryciton@sio.jjr.fr	qh!Wnqgx3
Mer	G�rard	g�rardmer@sio.jjr.fr	qh!Wnqgx3
Monlatin	Gilbert	gilbertmonlatin@sio.jjr.fr	qh!Wnqgx3
de Michelin	Guy	guyde michelin@sio.jjr.fr	qh!Wnqgx3
Ness	Guy	guyness@sio.jjr.fr	qh!Wnqgx3
Dehun	H�l�ne	h�l�nedehun@sio.jjr.fr	qh!Wnqgx3
Sarav	Igor	igorsarav@sio.jjr.fr	qh!Wnqgx3
Lepoisson	Ivanho�	ivanho�lepoisson@sio.jjr.fr	qh!Wnqgx3
Tretou	Jean-R�gis	jean-r�gistretou@sio.jjr.fr	qh!Wnqgx3
Calva	Justin	justincalva@sio.jjr.fr	qh!Wnqgx3
Page	Marc	marcpage@sio.jjr.fr	qh!Wnqgx3
Tim	Marie	marietim@sio.jjr.fr	qh!Wnqgx3
Cambronne	Maude	maudecambronne@sio.jjr.fr	qh!Wnqgx3
Enroute	M�lodie	m�lodieenroute@sio.jjr.fr	qh!Wnqgx3
Archi	Sue	suearchi@sio.jjr.fr	qh!Wnqgx3
Incoufin	Pat	patincoufin@sio.jjr.fr	qh!Wnqgx3
