Conda	Anna	annaconda@sio.jjr.fr	Iq5tiv$fz
Gramme	Anna	annagramme@sio.jjr.fr	Iq5tiv$fz
Show	Arty	artyshow@sio.jjr.fr	Iq5tiv$fz
Bor�al	Aurore	aurorebor�al@sio.jjr.fr	Iq5tiv$fz
Sonjoli	Axelle	axellesonjoli@sio.jjr.fr	Iq5tiv$fz
Ohazar	Balthazar	balthazarohazar@sio.jjr.fr	Iq5tiv$fz
de Koch	Basile	basilede koch@sio.jjr.fr	Iq5tiv$fz
Pacher	Bonaparte	bonapartepacher@sio.jjr.fr	Iq5tiv$fz
Glace	Brice	briceglace@sio.jjr.fr	Iq5tiv$fz
Nulpart	Carmen	carmennulpart@sio.jjr.fr	Iq5tiv$fz
Trophob	Claus	claustrophob@sio.jjr.fr	Iq5tiv$fz
Molette	Cl�a	cl�amolette@sio.jjr.fr	Iq5tiv$fz
Sil	Cody	codysil@sio.jjr.fr	Iq5tiv$fz
Rondi	Deborah	deborahrondi@sio.jjr.fr	Iq5tiv$fz
�pi	Fany	fany�pi@sio.jjr.fr	Iq5tiv$fz
Passy	Flore	florepassy@sio.jjr.fr	Iq5tiv$fz
Citon	Garry	garryciton@sio.jjr.fr	Iq5tiv$fz
Mer	G�rard	g�rardmer@sio.jjr.fr	Iq5tiv$fz
Monlatin	Gilbert	gilbertmonlatin@sio.jjr.fr	Iq5tiv$fz
de Michelin	Guy	guyde michelin@sio.jjr.fr	Iq5tiv$fz
Ness	Guy	guyness@sio.jjr.fr	Iq5tiv$fz
Dehun	H�l�ne	h�l�nedehun@sio.jjr.fr	Iq5tiv$fz
Sarav	Igor	igorsarav@sio.jjr.fr	Iq5tiv$fz
Lepoisson	Ivanho�	ivanho�lepoisson@sio.jjr.fr	Iq5tiv$fz
Tretou	Jean-R�gis	jean-r�gistretou@sio.jjr.fr	Iq5tiv$fz
Calva	Justin	justincalva@sio.jjr.fr	Iq5tiv$fz
Page	Marc	marcpage@sio.jjr.fr	Iq5tiv$fz
Tim	Marie	marietim@sio.jjr.fr	Iq5tiv$fz
Cambronne	Maude	maudecambronne@sio.jjr.fr	Iq5tiv$fz
Enroute	M�lodie	m�lodieenroute@sio.jjr.fr	Iq5tiv$fz
Archi	Sue	suearchi@sio.jjr.fr	Iq5tiv$fz
Incoufin	Pat	patincoufin@sio.jjr.fr	Iq5tiv$fz
