Conda	Anna	annaconda@sio.jjr.fr	glan7Ss:p
Gramme	Anna	annagramme@sio.jjr.fr	sCvmk?ew7
Show	Arty	artyshow@sio.jjr.fr	vgitBlµw3
Bor�al	Aurore	aurorebor�al@sio.jjr.fr	µys9vnaCf
Sonjoli	Axelle	axellesonjoli@sio.jjr.fr	lhBsp.m5i
Ohazar	Balthazar	balthazarohazar@sio.jjr.fr	9oLq}gegs
de Koch	Basile	basilede koch@sio.jjr.fr	w~z6xOgep
Pacher	Bonaparte	bonapartepacher@sio.jjr.fr	ovrc]Eoi4
Glace	Brice	briceglace@sio.jjr.fr	µdvo6ajlM
Nulpart	Carmen	carmennulpart@sio.jjr.fr	tIx9ynjq<
Trophob	Claus	claustrophob@sio.jjr.fr	~ekbwdEl3
Molette	Cl�a	cl�amolette@sio.jjr.fr	0rQ£zxhqh
Sil	Cody	codysil@sio.jjr.fr	§3xfhtlrZ
Rondi	Deborah	deborahrondi@sio.jjr.fr	kQnry6w+z
�pi	Fany	fany�pi@sio.jjr.fr	1y}gyOsxi
Passy	Flore	florepassy@sio.jjr.fr	knlzbqE0(
Citon	Garry	garryciton@sio.jjr.fr	Gj)cn2pzv
Mer	G�rard	g�rardmer@sio.jjr.fr	b&7teiAuo
Monlatin	Gilbert	gilbertmonlatin@sio.jjr.fr	1P)cqqpes
de Michelin	Guy	guyde michelin@sio.jjr.fr	m5akY£ifo
Ness	Guy	guyness@sio.jjr.fr	meJ9g$fsm
Dehun	H�l�ne	h�l�nedehun@sio.jjr.fr	z,Oii4zov
Sarav	Igor	igorsarav@sio.jjr.fr	p{k7Aqcvk
Lepoisson	Ivanho�	ivanho�lepoisson@sio.jjr.fr	b,y8duRpb
Tretou	Jean-R�gis	jean-r�gistretou@sio.jjr.fr	O2xt.hjkb
Calva	Justin	justincalva@sio.jjr.fr	2ojskhjE.
Page	Marc	marcpage@sio.jjr.fr	rsbni2i;T
Tim	Marie	marietim@sio.jjr.fr	lnmo{5sBq
Cambronne	Maude	maudecambronne@sio.jjr.fr	Ofof3+dmq
Enroute	M�lodie	m�lodieenroute@sio.jjr.fr	jwqrxS3g[
Archi	Sue	suearchi@sio.jjr.fr	@f5bxqjPv
Incoufin	Pat	patincoufin@sio.jjr.fr	y^hphb1uO
